"filename", "language", "JSON", "Markdown", "JavaScript", "JavaScript JSX", "CSS", "comment", "blank", "total"
"/Users/antoninnicolas/Desktop/2024-2029/Stepify/README.md", "Markdown", 0, 11, 0, 0, 0, 0, 2, 13
"/Users/antoninnicolas/Desktop/2024-2029/Stepify/backend/api/index.js", "JavaScript", 0, 0, 44, 0, 0, 7, 9, 60
"/Users/antoninnicolas/Desktop/2024-2029/Stepify/backend/config/cloudinary.js", "JavaScript", 0, 0, 8, 0, 0, 0, 2, 10
"/Users/antoninnicolas/Desktop/2024-2029/Stepify/backend/controllers/AccountController.js", "JavaScript", 0, 0, 325, 0, 0, 10, 64, 399
"/Users/antoninnicolas/Desktop/2024-2029/Stepify/backend/controllers/AuthController.js", "JavaScript", 0, 0, 555, 0, 0, 23, 90, 668
"/Users/antoninnicolas/Desktop/2024-2029/Stepify/backend/controllers/StepController.js", "JavaScript", 0, 0, 164, 0, 0, 10, 40, 214
"/Users/antoninnicolas/Desktop/2024-2029/Stepify/backend/middlewares/VerifyAuthorization.js", "JavaScript", 0, 0, 7, 0, 0, 0, 1, 8
"/Users/antoninnicolas/Desktop/2024-2029/Stepify/backend/middlewares/VerifyToken.js", "JavaScript", 0, 0, 19, 0, 0, 0, 3, 22
"/Users/antoninnicolas/Desktop/2024-2029/Stepify/backend/middlewares/multer.js", "JavaScript", 0, 0, 4, 0, 0, 0, 2, 6
"/Users/antoninnicolas/Desktop/2024-2029/Stepify/backend/models/Challenge.js", "JavaScript", 0, 0, 22, 0, 0, 0, 5, 27
"/Users/antoninnicolas/Desktop/2024-2029/Stepify/backend/models/Reward.js", "JavaScript", 0, 0, 19, 0, 0, 0, 0, 19
"/Users/antoninnicolas/Desktop/2024-2029/Stepify/backend/models/StepEntry.js", "JavaScript", 0, 0, 33, 0, 0, 0, 5, 38
"/Users/antoninnicolas/Desktop/2024-2029/Stepify/backend/models/User.js", "JavaScript", 0, 0, 271, 0, 0, 10, 12, 293
"/Users/antoninnicolas/Desktop/2024-2029/Stepify/backend/package-lock.json", "JSON", 1843, 0, 0, 0, 0, 0, 1, 1844
"/Users/antoninnicolas/Desktop/2024-2029/Stepify/backend/package.json", "JSON", 36, 0, 0, 0, 0, 0, 1, 37
"/Users/antoninnicolas/Desktop/2024-2029/Stepify/backend/routes/AccountRoutes.js", "JavaScript", 0, 0, 34, 0, 0, 5, 5, 44
"/Users/antoninnicolas/Desktop/2024-2029/Stepify/backend/routes/AuthRoutes.js", "JavaScript", 0, 0, 33, 0, 0, 5, 7, 45
"/Users/antoninnicolas/Desktop/2024-2029/Stepify/backend/routes/StepRoutes.js", "JavaScript", 0, 0, 24, 0, 0, 5, 4, 33
"/Users/antoninnicolas/Desktop/2024-2029/Stepify/backend/utils/EmailTemplates.js", "JavaScript", 0, 0, 1614, 0, 0, 0, 82, 1696
"/Users/antoninnicolas/Desktop/2024-2029/Stepify/backend/utils/GenerateAuthCookie.js", "JavaScript", 0, 0, 25, 0, 0, 0, 5, 30
"/Users/antoninnicolas/Desktop/2024-2029/Stepify/backend/utils/GenerateCode.js", "JavaScript", 0, 0, 4, 0, 0, 0, 1, 5
"/Users/antoninnicolas/Desktop/2024-2029/Stepify/backend/utils/ParseHealthData.js", "JavaScript", 0, 0, 143, 0, 0, 7, 30, 180
"/Users/antoninnicolas/Desktop/2024-2029/Stepify/backend/utils/SendMail.js", "JavaScript", 0, 0, 107, 0, 0, 1, 10, 118
"/Users/antoninnicolas/Desktop/2024-2029/Stepify/backend/utils/StatsUtils.js", "JavaScript", 0, 0, 60, 0, 0, 0, 16, 76
"/Users/antoninnicolas/Desktop/2024-2029/Stepify/backend/vercel.json", "JSON", 9, 0, 0, 0, 0, 0, 0, 9
"/Users/antoninnicolas/Desktop/2024-2029/Stepify/frontend/src/App.css", "CSS", 0, 0, 0, 0, 4, 0, 0, 4
"/Users/antoninnicolas/Desktop/2024-2029/Stepify/frontend/src/App.jsx", "JavaScript JSX", 0, 0, 0, -3, 0, 0, 0, -3
"/Users/antoninnicolas/Desktop/2024-2029/Stepify/frontend/src/context/AuthContext.jsx", "JavaScript JSX", 0, 0, 0, 0, 0, 0, -1, -1
"/Users/antoninnicolas/Desktop/2024-2029/Stepify/frontend/src/context/LoadingContext.jsx", "JavaScript JSX", 0, 0, 0, -33, 0, 0, -7, -40
"/Users/antoninnicolas/Desktop/2024-2029/Stepify/frontend/src/context/ThemeContext.jsx", "JavaScript JSX", 0, 0, 0, 11, 0, 4, 4, 19
"/Users/antoninnicolas/Desktop/2024-2029/Stepify/frontend/src/context/UserContext.jsx", "JavaScript JSX", 0, 0, 0, 2, 0, 0, -4, -2
"/Users/antoninnicolas/Desktop/2024-2029/Stepify/frontend/src/layouts/LoaderLayout.jsx", "JavaScript JSX", 0, 0, 0, -14, 0, 0, -2, -16
"/Users/antoninnicolas/Desktop/2024-2029/Stepify/frontend/src/pages/Auth/ChangeEmail.jsx", "JavaScript JSX", 0, 0, 0, -2, 0, 0, 0, -2
"/Users/antoninnicolas/Desktop/2024-2029/Stepify/frontend/src/pages/Auth/EmailVerification.jsx", "JavaScript JSX", 0, 0, 0, -2, 0, 0, 0, -2
"/Users/antoninnicolas/Desktop/2024-2029/Stepify/frontend/src/pages/Auth/Forgot-pwd.jsx", "JavaScript JSX", 0, 0, 0, -2, 0, 0, 0, -2
"/Users/antoninnicolas/Desktop/2024-2029/Stepify/frontend/src/pages/Auth/Login.jsx", "JavaScript JSX", 0, 0, 0, -2, 0, 0, 0, -2
"/Users/antoninnicolas/Desktop/2024-2029/Stepify/frontend/src/pages/Auth/Reset-pwd.jsx", "JavaScript JSX", 0, 0, 0, -2, 0, 0, 0, -2
"/Users/antoninnicolas/Desktop/2024-2029/Stepify/frontend/src/pages/Dashboard.jsx", "JavaScript JSX", 0, 0, 0, -2, 0, 0, 0, -2
"/Users/antoninnicolas/Desktop/2024-2029/Stepify/frontend/src/pages/Steps.jsx", "JavaScript JSX", 0, 0, 0, 1, 0, 0, -1, 0
"/Users/antoninnicolas/Desktop/2024-2029/Stepify/frontend/src/routes/AppRoutes.jsx", "JavaScript JSX", 0, 0, 0, -3, 0, 0, 0, -3
"/Users/antoninnicolas/Desktop/2024-2029/Stepify/frontend/src/routes/RoutesGuards.jsx", "JavaScript JSX", 0, 0, 0, -5, 0, 0, 0, -5
"/Users/antoninnicolas/Desktop/2024-2029/Stepify/frontend/src/utils/GlobalLoader.jsx", "JavaScript JSX", 0, 0, 0, -3, 0, 0, -2, -5
"/Users/antoninnicolas/Desktop/2024-2029/Stepify/package-lock.json", "JSON", 13, 0, 0, 0, 0, 0, 1, 14
"/Users/antoninnicolas/Desktop/2024-2029/Stepify/package.json", "JSON", 21, 0, 0, 0, 0, 0, 1, 22
"Total", "-", 1922, 11, 3515, -59, 4, 87, 386, 5866